慝	aadn
菡	abib
荪	abiu
菰	abry
蓣	acnm
蕻	adaw
葫	adef
苈	ader
萘	adfi
葜	adhd
茬	adhf
苤	adhg
惹	adkn
蒇	admu
蕨	aduw
蓁	adwt
萁	adwu
莩	aebf
蒯	aeej
萸	aewu
鞴	afae
鞲	afaf
鞣	afcs
芸	afcu
芰	afcu
鞑	afdp
鞋	afff
葑	afff
鞘	afie
鞅	afmd
荸	afpb
芫	afqb
鞠	afqo
鞔	afqq
莰	afqw
鞫	afqy
藕	afsy
蓍	aftj
鞒	aftj
菱	afwt
靴	afwx
藿	afwy
蕤	ageg
廿	aghg
艹	aghh
颟	agmm
巧	agnn
戈	agny
薤	agqg
荚	agud
苹	aguf
莱	agus
匪	ahdd
苫	ahkf
赜	ahkm
熙	ahko
卧	ahnh
鸦	ahtg
迓	ahtp
雅	ahty
蕖	aias
菠	aibu
薄	aisf
菏	aisk
落	aitk
藩	aitl
蒗	aiyv
募	ajde
墓	ajdf
蓦	ajdg
幕	ajdh
暮	ajdj
慕	ajdn
摹	ajdr
莳	ajfu
菖	ajjf
鹊	ajqg
蕺	akby
鄞	akgb
堇	akgf
惑	akgn
觐	akgq
蒉	akhm
莒	akkf
鹳	akkg
萼	akkn
蒽	aldn
茴	alkf
瞢	alph
薨	alpx
甍	alpy
鹋	alqg
遘	amfp
觏	amfq
萜	amhk
芮	amwu
葭	anhc
荬	anud
荩	anyu
苡	anyw
薮	aovt
蔻	apfc
茔	apff
莞	apfq
苎	apgf
萱	apgg
菅	apnf
蓥	apqf
莺	apqg
蓿	apwj
茚	aqgb
茑	aqgf
藓	aqgu
苟	aqkf
茗	aqkf
擎	aqkr
檠	aqks
敬	aqkt
菟	aqky
芴	aqrr
茆	aqtb
获	aqtd
荻	aqto
莸	aqty
鸥	arqg
蔸	arqq
蘸	asgo
蔌	askw
荞	atdj
翳	atdn
蓬	atdp
莛	atfp
茱	atfu
翘	atgn
薰	atgo
尧	atgq
荇	atgs
孽	atnb
蘖	atns
蘅	atqs
莓	atxu
薏	aujn
蕲	aujr
薅	avdf
苕	avkf
芟	awcu
荟	awfc
茌	awff
苻	awfu
荃	awgf
莶	awgg
荼	awgs
蔹	awgt
恭	awnu
荷	awsk
蓓	awuk
觋	awwq
苁	awwu
苓	awyc
萑	awyf
跫	awyh
蛩	awyj
劐	awyj
芩	awyn
蕉	awyo
銎	awyq
巩	awyy
荜	axxf
蒈	axxr
荠	ayjj
藁	ayms
匾	ayna
芒	aynb
荒	aynk
蒡	ayuy
菸	aywu
蕹	ayxy
颞	bccm
鄹	bcib
戤	bcla
隳	bdan
堕	bdef
陟	bhht
阽	bhkg
丞	bigf
聃	bmfg
孑	bnhg
皮	bnty
陲	btgf
聪	bukn
坠	bwff
险	bwgg
陔	bynw
刭	cajh
垒	cccf
叠	cccg
颡	cccm
桑	cccs
恿	cenu
特	cffy
怼	cfnu
骁	cgaq
驰	cgbn
骖	cgce
驿	cgcg
骚	cgcj
骀	cgck
骏	cgct
骐	cgdw
驮	cgdy
牾	cgkg
驶	cgkr
驷	cglg
骝	cgql
驺	cgqv
骆	cgtk
骢	cgtn
骥	cguw
驸	cgwf
骅	cgwf
骓	cgwy
骗	cgya
骧	cgye
驻	cgyg
骟	cgyn
骇	cgyw
豫	cnhe
鹜	cnhg
骛	cnhg
鹬	cnhg
瞀	cnhh
蟊	cnhj
蝥	cnhj
预	cnhm
矜	cnhn
鍪	cnhq
柔	cnhs
矛	cnht
婺	cnhv
牟	ctgj
逡	cwtp
磺	damw
砹	dary
靥	dddf
飙	dddr
砺	ddgq
餍	ddwv
硼	deeg
髡	degq
鬓	depw
鬏	deto
鬣	devn
砝	dfcy
辱	dfef
蜃	dfej
唇	dfek
硅	dffg
夸	dfnb
刳	dfnj
匏	dfnn
瓠	dfny
硎	dgaj
厨	dgkf
感	dgkn
励	dgqe
石	dgtg
犬	dgty
戊	dgty
硖	dgud
砉	dhdf
彗	dhdv
邳	dhgb
丕	dhgd
戚	dhii
否	dhkf
砧	dhkg
孬	dhvb
恝	dhvn
挈	dhvr
鹌	djng
耐	dmjf
鸸	dmjg
恧	dmjn
耍	dmjv
碇	dpgh
磔	dqgs
剞	dskj
欹	dskw
帮	dtbh
焘	dtfo
厥	dubw
舂	dwef
奏	dwgd
硷	dwgg
磴	dwgu
泰	dwiu
蠢	dwjj
戡	dwna
甚	dwnb
勘	dwne
斟	dwnf
砜	dwry
赝	dwwm
碓	dwyg
礁	dwyo
砻	dxyd
袭	dxye
垄	dxyf
龚	dxyw
碥	dyna
碲	dyuh
膜	eajd
貘	eajd
腊	eajg
腌	edjn
毳	eeeb
勰	eeen
腴	eewy
脚	efcb
虢	efhw
臌	efkc
悬	egcn
腈	egeg
豚	egey
胂	ejhh
臊	ekks
脶	ekmw
哿	eksk
爨	emgo
璺	emgy
鼷	enud
鼯	enuk
鼬	enum
鼹	enuv
鼢	enuv
脘	epfq
舜	epqg
膣	epwf
膘	esfi
鹞	etfg
繇	etfi
毛	etgn
胙	ethf
貉	etkg
塍	eugf
腾	eugg
滕	eugi
媵	eugv
腱	evgp
腧	ewgj
胲	eynw
膪	eyuk
腋	eywy
堰	fajv
戴	falw
截	fawy
劫	fcet
坜	fdet
垮	fdfn
坯	fdhg
颥	fdmm
顸	fdmy
土	ffff
封	fffy
埴	ffhg
卦	ffhy
圬	ffnn
恚	ffnu
干	fggh
未	fggy
甘	fghg
雨	fghy
寸	fghy
埂	fgjr
赶	fhfk
趔	fhgj
赳	fhnh
垆	fhnt
趑	fhuw
趁	fhwe
颠	fhwm
霪	fief
韩	fjfh
埘	fjfy
堤	fjgh
斡	fjwf
露	fkhk
埙	fkmy
鼓	fkuc
彭	fkue
鼙	fkuf
瞽	fkuh
嘉	fkuk
熹	fkuo
甏	fkuy
坍	fmyg
堀	fnbm
霞	fnhc
韬	fnhe
韫	fnhl
违	fnhp
韧	fnhy
场	fnrt
觌	fnuq
罄	fnwb
磬	fnwd
馨	fnwj
謦	fnwy
赧	fobc
赭	fofj
螫	fotj
赦	foty
墉	fovh
孛	fpbf
鹁	fpbg
彀	fpgc
觳	fpgc
懿	fpgn
悫	fpwn
坨	fpxn
堍	fqky
耩	fsaf
耘	fsfc
堙	fsfg
耕	fsfj
耥	fsik
耖	fsit
耧	fsov
耪	fsyy
教	ftbt
都	ftjb
翥	ftjn
煮	ftjo
坞	ftng
圪	ftnn
耄	ftxe
耋	ftxf
耆	ftxj
霉	ftxu
霍	fwyf
埝	fwyn
霭	fyjn
墒	fyuk
琊	gahb
鹉	gahg
型	gajf
刑	gajh
璜	gamw
顿	gbnm
郅	gcfb
致	gcft
臻	gcft
燹	gego
瑷	gepc
靛	geph
夫	gggy
鄢	ghgb
璩	ghge
丐	ghnv
逑	giyp
救	giyt
瑁	gjhg
蠹	gkhj
璐	gkhk
橐	gkhs
噩	gkkk
逼	gklp
鬲	gkmh
翮	gkmn
豇	gkua
豌	gkub
豉	gkuc
逗	gkup
曹	gmaj
璎	gmmv
邴	gmwb
两	gmww
璀	gmwy
郦	gmyb
鹂	gmyg
逦	gmyp
戬	goja
殂	gqeg
劢	gqet
殪	gqfu
麸	gqgy
珧	gqiy
裂	gqje
虺	gqji
烈	gqjo
虿	gqju
殒	gqkm
殡	gqpw
聱	gqtb
獒	gqtd
歼	gqtf
鳌	gqtg
骜	gqtg
螯	gqtj
赘	gqtm
熬	gqto
遨	gqtp
鏊	gqtq
殇	gqtr
敖	gqty
殄	gqwe
殓	gqwg
餮	gqwv
瓒	gtfm
郏	gudb
颊	gudm
璇	gyth
眶	hagg
裴	hdhe
韭	hdhg
蜚	hdhj
辈	hdhl
翡	hdhn
斐	hdhy
瞌	hfcl
芈	hghg
眄	hghn
颦	hhdf
虍	hhgn
氍	hhwe
瞿	hhwy
颅	hndm
兕	hnhq
睿	hpgh
龄	hwbc
龌	hwbf
龃	hwbg
龊	hwbh
龉	hwbk
龆	hwbk
龅	hwbn
龈	hwbv
龇	hwbx
龀	hwbx
龋	hwby
睽	hwgd
睑	hwgg
盼	hwvt
睢	hwyg
满	iagw
泄	iann
渠	ians
渫	ians
潆	iapi
滢	iapy
潇	iavw
港	iawn
浚	icwt
洧	ideg
沥	idet
溽	idff
沣	idhh
澌	idwr
溱	idwt
淇	idwy
溘	ifcl
洼	iffg
滇	ifhw
瀚	ifjn
澎	ifke
澍	ifkf
渎	ifnd
涿	igey
潜	iggj
浯	igkg
沛	igmh
漕	igmj
辉	igql
耀	igqy
涞	igus
举	igwg
誉	igwy
濒	ihhm
渺	ihit
泸	ihnt
裟	iite
鲨	iitg
挲	iitr
娑	iitv
涅	ijfg
漫	ijlc
浞	ikhy
漶	ikkn
洇	ildy
溷	ilge
淠	ilgj
泱	imdy
洞	imgk
氅	imke
敞	imkt
澉	inbt
汛	infh
烫	inro
泼	inty
淙	ipfi
浣	ipfq
渲	ipgg
淀	ipgh
演	ipgw
溟	ipju
裳	ipke
堂	ipkf
赏	ipkm
掌	ipkr
棠	ipks
鲎	ipqg
溶	ipwk
深	ipws
渔	iqgg
泖	iqtb
潴	iqtj
漪	iqtk
溜	iqyl
湃	irdf
浠	irdh
湟	irgg
湮	isfg
溥	isfy
酒	isgg
湘	ishg
渣	isjg
涑	iskg
濑	iskm
漱	iskw
潸	isse
漤	issv
溧	issy
淞	iswc
沭	isyy
鋈	itdq
沃	itdy
劣	iter
浩	itfk
洙	itfy
溴	ithd
瞥	ithf
洎	ithg
濞	ithj
涎	ithp
蹩	itkh
泺	itni
汔	itnn
渊	itoh
湫	itoy
润	iugg
泮	iugh
漾	iugi
潼	iujf
涧	iujg
涕	iuxt
津	ivgh
洳	ivkg
粱	ivwo
瀹	iwga
溆	iwgc
渝	iwgj
涂	iwgs
潋	iwgt
澄	iwgu
湓	iwvl
泠	iwyc
雀	iwyf
鎏	iycq
澈	iyct
沩	iyey
泳	iyni
滦	iyos
游	iytb
浒	iytf
漩	iyth
滂	iyuy
淬	iywf
沆	iywn
淤	iywu
氵	iyyg
螨	jagw
蟆	jajd
蝾	japs
蠖	jawc
蛹	jceh
蛎	jdgq
螓	jdwt
昃	jdwu
蜞	jdwy
蛆	jegg
墅	jfcf
昙	jfcu
蠕	jfdj
蜻	jgeg
韪	jghh
匙	jghx
虾	jghy
蝠	jgkl
螬	jgmj
蠼	jhhc
曰	jhng
虫	jhny
日	jjjj
蜴	jjqr
蜩	jmfk
愚	jmhn
禺	jmhy
蠊	jouw
螗	jovk
暝	jpju
晖	jplh
蟓	jqke
煦	jqko
剔	jqrj
曷	jqwn
歇	jqww
蜥	jsrh
蛞	jtdg
蜘	jtdk
蜓	jtfp
戥	jtga
曛	jtgo
蚱	jthf
晷	jthk
螅	jthn
蜒	jthp
蝮	jtjt
蟋	jton
临	jtyj
监	jtyl
蚪	jufh
曦	jugy
蟑	jujh
照	jvko
蝓	jwgj
蜍	jwgs
晗	jwyk
暹	jwyp
颢	jyim
晾	jyiy
虻	jynn
螭	jyrc
喋	kans
呕	kary
嗬	kawk
嗒	kawk
嗤	kbhj
戢	kbny
啜	kccc
哞	kctg
喊	kdgk
呸	kdhg
嘁	kdhi
嗄	kdht
噘	kduw
唪	kdwg
嗪	kdwt
呔	kdyy
嗑	kfcl
嘭	kfke
咭	kfkg
嚏	kfph
嗦	kfpi
嘟	kftb
嗜	kftj
郢	kgbh
吁	kgfh
唔	kgkg
嗝	kgkh
啧	kgmy
嗷	kgqt
咦	kgxw
躇	khaj
跷	khaq
蹀	khas
蹒	khaw
躏	khay
蹑	khbc
跛	khby
跆	khck
蹂	khcs
啡	khdd
踌	khdf
蹰	khdf
跖	khdg
蹶	khdw
跋	khdy
蹊	khed
蹈	khee
跏	khek
踩	khes
趼	khga
噱	khge
贵	khgm
遗	khgp
遣	khgp
趺	khgy
踔	khhj
咔	khhy
蹋	khjn
踝	khjs
躅	khlj
跚	khmg
踹	khmj
踞	khnd
跽	khnn
踱	khoc
躔	khof
蹼	khog
踮	khok
蹿	khph
跎	khpx
跪	khqb
跳	khqi
趵	khqy
跃	khtd
踵	khtf
跌	khtg
鹭	khtg
跞	khti
踟	khtk
蹯	khtl
躜	khtm
跹	khtp
跣	khtq
踽	khty
踯	khub
蹲	khuf
蹭	khuj
踣	khuk
跤	khur
躐	khvn
踺	khvp
啮	khwb
跄	khwb
跗	khwf
唬	khwn
跺	khws
蹬	khwu
跸	khxf
呲	khxn
蹁	khya
躞	khyc
蹄	khyh
跻	khyj
踉	khyv
蹴	khyy
嚣	kkdk
哭	kkdu
鹗	kkfg
颚	kkfm
患	kkhn
口	kkkk
噪	kkks
嗯	kldn
啭	klfy
嘣	kmee
剐	kmwj
呙	kmwu
哪	kngb
喔	kngf
咤	kpta
噜	kqgj
唿	kqrn
唏	krdh
哳	krrh
喇	kskj
嗽	kskw
啉	kssy
吒	ktan
嗅	kthd
咋	kthf
川	kthh
噢	ktmd
咚	ktuy
吖	kuhh
噫	kujn
哙	kwfc
啥	kwfk
喻	kwgj
噔	kwgu
喉	kwnd
哚	kwsy
咿	kwvt
噙	kwyc
呤	kwyc
唯	kwyg
吟	kwyn
噍	kwyo
喙	kxey
咝	kxxg
吡	kxxn
喈	kxxr
唳	kynd
咳	kynw
嘀	kyud
啐	kywf
辍	lccc
罴	lfco
置	lfhf
围	lfnh
默	lfod
黩	lfod
黝	lfoe
黪	lfoe
墨	lfof
黥	lfoi
黯	lfoj
黠	lfok
黜	lfom
黔	lfon
黟	lfoq
黢	lfot
圊	lged
圄	lgkd
囗	lhng
甲	lhnh
轳	lhnt
轷	ltuf
圈	lugb
畛	lwet
辁	lwgg
囵	lwxv
辔	lxxk
嵘	maps
赈	mdfe
崖	mdff
岸	mdfj
崴	mdgv
遄	mdmp
骷	medg
髋	mepq
髌	mepw
骶	meqy
骺	merk
骱	mewj
雕	mfky
岍	mgah
崃	mgus
帻	mhgm
帖	mhhk
幔	mhjc
幌	mhjq
贴	mhkg
帜	mhkw
幄	mhnf
贝	mhny
帙	mhtg
幡	mhtl
幛	mhuj
帷	mhwy
删	mmgj
峒	mmgk
鹦	mmvg
刿	mqjh
峤	mtdj
嶝	mwgu
峪	mwwk
岭	mwyc
岑	mwyn
惜	najg
愍	natn
臀	nawe
憾	ndgn
恸	nfce
怯	nfcy
忮	nfcy
尉	nfif
熨	nfio
悖	nfpb
悟	ngkg
悱	nhdd
悼	nhjh
屑	nied
悝	njfg
愦	nkhm
襞	nkue
壁	nkuf
辟	nkuh
鐾	nkuq
擘	nkur
檗	nkus
劈	nkuv
嬖	nkuv
譬	nkuy
璧	nkuy
甓	nkuy
怏	nmdy
巳	nngn
尸	nngt
忸	nnhg
慷	novi
屐	ntfc
忤	ntfh
屣	nthh
愎	ntjt
恪	ntkg
愀	ntoy
憧	nujf
鹨	nweg
戳	nwya
怜	nwyc
翟	nwyf
憔	nwyo
忄	nyhy
惊	nyiy
悴	nywf
炼	oanw
庹	oany
鹧	oaog
遮	oaop
烘	oawy
糅	ocns
煳	odeg
粝	odgq
糟	ogmj
粘	ohkg
廛	ojff
炀	onrt
廖	onwe
焱	ooou
糠	oovi
粽	opfi
廨	oqeg
遴	oqgp
庖	oqnv
熘	oqyl
魔	ossc
麽	ossc
磨	ossd
靡	ossd
麾	osse
縻	ossi
糜	osso
摩	ossr
煅	othc
糗	othd
糌	othj
熄	othn
凿	oufb
焙	oukg
赓	ovwm
腐	owfw
膺	owwe
鹰	owwg
麝	oxxf
麟	oxxg
麈	oxxg
麋	oxxo
鏖	oxxq
麇	oxxt
麂	oxxw
麒	oxxw
煸	oyna
庐	oyne
煽	oynn
廊	oyvb
粹	oywf
褰	pawe
塞	pawf
骞	pawg
蹇	pawh
搴	pawr
寨	paws
謇	pawy
宥	pdef
宸	pdfe
割	pdhj
寇	pfqc
冠	pfqf
皲	plby
蜜	pntj
宓	pntr
衩	pucy
褂	pufh
襦	pufj
寐	pufu
衬	pufy
裱	puge
寤	pugk
袒	pujg
褴	pujl
褐	pujn
裼	pujr
裸	pujs
衲	pumw
褶	punr
袂	punw
褛	puov
褫	purw
襻	pusr
衽	putf
袼	putk
袢	puug
裥	puuj
寝	puvc
裙	puvk
褪	puvp
裉	puvy
袱	puwd
裣	puwg
袷	puwk
衿	puwn
褓	puws
衤	puyy
穿	pwat
窃	pwav
窿	pwbg
宿	pwdj
窦	pwfd
察	pwfi
窒	pwgf
窀	pwgn
窜	pwkh
穸	pwqu
窑	pwtb
窄	pwtf
窖	pwtk
窆	pwtp
窨	pwuj
邃	pwup
窘	pwvk
窬	pwwj
窈	pwxe
禊	pydd
祜	pydg
祺	pydw
祓	pydy
禧	pyfk
祆	pygd
祯	pyhm
祸	pykw
祠	pynk
礼	pynn
祀	pynn
辶	pyny
祢	pyqi
祗	pyqy
禅	pyuf
禚	pyuo
宀	pyyn
礻	pyyy
镆	qajd
昏	qajf
钺	qann
铽	qany
鸱	qayg
氐	qayi
眢	qbhf
钚	qdhy
镢	qduw
锾	qegc
锄	qege
觞	qetr
觯	qeuf
蟹	qevj
邂	qevp
铐	qftn
铑	qftx
鳓	qgae
鲽	qgas
鲰	qgbc
钝	qgbn
鲐	qgck
鲔	qgde
鲕	qgdj
鳜	qgdw
鱿	qgdy
鲅	qgdy
锖	qgeg
鲵	qgeq
鲑	qgff
鳍	qgfj
鲒	qgfk
鲼	qgfm
鲮	qgft
鳕	qgfv
鲆	qggf
鲠	qggr
鲡	qggy
鲱	qghd
钲	qghg
鲇	qghk
钙	qghn
鲈	qghn
鳗	qgjc
鲤	qgjf
鲥	qgjf
鲣	qgjf
鲳	qgjj
鳎	qgjn
鲲	qgjx
匐	qgkl
鳄	qgkn
鲴	qgld
鳏	qgli
鲢	qglp
鳢	qgmu
鳙	qgoh
鲩	qgpq
桀	qgsu
鳅	qgto
鲦	qgts
鳆	qgtt
稣	qgty
铗	qgud
鳟	qguf
鳝	qguk
鲛	qgur
铼	qgus
鲟	qgvf
鲻	qgvl
鲶	qgwn
鳊	qgya
鲚	qgyj
鲂	qgyt
钰	qgyy
镗	qipf
迩	qipi
钽	qjgg
劬	qket
钟	qkhh
锷	qkkn
铞	qkmh
勉	qkqe
鸲	qkqg
逸	qkqp
够	qkqq
兔	qkqy
铟	qldy
镯	qlqj
铜	qmgk
馍	qnad
馑	qnag
馓	qnat
饵	qnbg
馊	qnec
馕	qnge
饨	qngn
镅	qnhg
馒	qnjc
刨	qnjh
馄	qnjx
饲	qnnk
锔	qnnk
饧	qnnr
馔	qnnw
馅	qnqe
馏	qnql
饱	qnqn
馋	qnqu
饩	qnrn
饫	qntd
饬	qnte
饪	qntf
饷	qntk
铋	qntt
饿	qnty
馐	qnug
饺	qnur
馀	qnws
镰	qouw
镛	qovh
夤	qpgw
镲	qpwi
铯	qqcn
鑫	qqqf
镏	qqyl
狨	qtad
猎	qtaj
獾	qtay
卯	qtbh
狲	qtbi
猛	qtbl
锈	qtbt
狁	qtcq
猱	qtcs
狻	qtct
猢	qtde
獠	qtdi
猗	qtdk
獗	qtdw
犹	qtdy
猊	qteq
铥	qtfc
锸	qtfe
钎	qtfh
犴	qtfh
猪	qtfj
锆	qtfk
铤	qtfp
铣	qtfq
橥	qtfs
铢	qtfy
狭	qtgd
猜	qtge
锤	qtgf
锺	qtgf
狂	qtgg
钅	qtgn
逛	qtgp
镍	qths
狸	qtjf
猩	qtjg
狮	qtjh
猖	qtjj
猓	qtjs
狷	qtke
猬	qtle
狎	qtlh
猡	qtlq
猾	qtme
钨	qtng
狃	qtng
猸	qtnh
铄	qtni
夕	qtny
逖	qtop
犷	qtot
锹	qtoy
狩	qtpf
獬	qtqg
狰	qtqh
狍	qtqn
锇	qtry
猹	qtsg
獯	qtto
犭	qttt
獐	qtuj
獍	qtuq
卿	qtvb
犰	qtvn
狯	qtwc
猃	qtwg
猞	qtwk
狳	qtws
猕	qtxi
狒	qtxj
猝	qtyf
狺	qtyg
狼	qtyv
锎	quga
锩	qugb
锏	qujg
镱	qujn
锫	qukg
皱	qvby
键	qvgp
铪	qwgk
镎	qwgr
镫	qwgu
镌	qwyb
铃	qwyc
钤	qwyn
飧	qwyv
钒	qwyy
铳	qycq
袅	qyeu
锿	qyey
铈	qymh
孵	qytb
镞	qytd
镟	qyth
卵	qyty
镝	qyud
留	qyvl
遛	qyvp
锒	qyvy
摸	rajd
揠	rajv
揲	rans
拣	ranw
搭	rawk
搽	raws
拚	rcah
搡	rccs
抒	rcnh
揉	rcns
瓞	rcyg
搔	rcyj
郄	rdcb
振	rdfe
捱	rdff
拜	rdfh
捺	rdfi
皋	rdfj
翱	rdfn
郗	rdmb
欷	rdmw
颀	rdmy
撅	rduw
揍	rdwd
撕	rdwr
挂	rffg
遁	rfhp
撷	rfkm
捂	rgkg
逅	rgkp
抨	rguf
爬	rhyc
爪	rhyi
搅	ripq
撇	rity
捍	rjfh
抻	rjhh
捌	rkej
拐	rket
操	rkks
摁	rldn
掴	rlgy
搌	rnae
撖	rnbt
挪	rngb
撰	rnnw
摺	rnrg
擢	rnwy
搪	rovk
擞	rovt
氨	rpvd
撺	rpwh
擦	rpwi
挖	rpwn
探	rpws
魑	rqcc
魈	rqce
魁	rqcf
魅	rqcf
魍	rqcn
魉	rqcw
魃	rqcy
挽	rqkq
搀	rqku
兜	rqnq
皈	rrcy
抓	rrhy
踅	rrkh
魄	rrqc
誓	rryf
揸	rsjg
挢	rtdj
郫	rtfb
插	rtfe
鹎	rtfg
扦	rtfh
皓	rtfk
攒	rtfm
挺	rtfp
捶	rtgf
攥	rthi
擤	rthj
皤	rtol
揪	rtoy
氡	rtui
搓	ruag
掷	rudb
掸	rujf
揞	rujg
掊	rukg
搛	ruvw
势	rvye
垫	rvyf
鸷	rvyg
絷	rvyi
蛰	rvyj
贽	rvym
热	rvyo
挚	rvyr
揆	rwgd
拴	rwgg
揄	rwgj
拾	rwgk
搿	rwgr
掰	rwvr
扮	rwvt
携	rwyb
擒	rwyc
拎	rwyc
推	rwyg
捻	rwyn
掾	rxey
氟	rxjk
揩	rxxr
掠	ryiy
捩	rynd
掮	ryne
氦	rynw
敫	ryty
摘	ryud
掖	rywy
搐	ryxl
框	sagg
柽	scfg
杼	scnh
橘	scnk
懋	scnn
橱	sdgf
楔	sdhd
槭	sdhi
楱	sdwd
棒	sdwg
椿	sdwj
椹	sdwn
榛	sdwt
橇	seee
樗	sffn
甄	sfgy
植	sfhg
樾	sfhn
剽	sfij
飘	sfir
柰	sfiu
瓢	sfiy
楮	sftj
栲	sftn
栳	sftx
醛	sgag
醋	sgaj
桎	sgcf
醐	sgde
酤	sgdg
醢	sgdl
酞	sgdy
酵	sgfb
酝	sgfc
酐	sgfh
酎	sgfy
酽	sggt
酾	sggy
醵	sghe
西	sghg
甫	sghy
桓	sgjg
醍	sgjh
梗	sgjr
醌	sgjx
酲	sgkg
酮	sgmk
醴	sgmu
柄	sgmw
醪	sgne
醑	sgne
朽	sgnn
桠	sgog
醭	sgog
醣	sgok
酩	sgqk
杌	sgqn
酢	sgtf
酪	sgtk
醺	sgto
酰	sgtq
酶	sgtx
酥	sgty
醅	sguk
醮	sgwo
酴	sgws
醇	sgyb
醉	sgyf
醯	sgyl
酿	sgyv
栌	shnt
桄	sigq
榄	sjtq
哥	sksk
敕	skty
桐	smgk
栅	smmg
樨	snig
檫	spwi
榕	spwk
榷	spwy
檐	sqdy
桷	sqeh
枸	sqkg
杓	sqyy
栀	srgb
樊	srrd
皙	srrf
柝	sryy
麓	ssox
木	ssss
梵	sswy
栝	stdg
杵	stfh
梏	stfk
梃	stfp
桁	stgs
椴	sthc
槌	stnp
榇	susy
栓	swgg
榆	swgj
橙	swgu
枞	swwy
柃	swyc
檎	swyc
榫	swyf
樵	swyo
枇	sxxn
檩	syli
槁	symk
敷	syty
箧	tagd
笸	takf
篝	tamf
彻	tavt
筮	taww
迤	tbpv
笈	tbyu
榘	tdas
箴	tdgk
舔	tdgn
刮	tdjh
稽	tdnj
嵇	tdnm
鸹	tdqg
筹	tdtf
矫	tdtj
憩	tdtn
矮	tdtv
辞	tduh
簸	tdwb
矬	tdwf
雉	tdwy
矧	tdxh
稃	tebg
筋	teer
徂	tegg
缸	tfba
罅	tfbf
邾	tfbh
缶	tfbk
罐	tfby
街	tffs
待	tffy
稹	tfhw
徒	tfhy
郜	tfkb
靠	tfkd
告	tfkf
秸	tfkg
鹄	tfkg
造	tfkp
廷	tfpd
迕	tfpk
赞	tfqm
选	tfqp
筠	tfqu
穑	tfuk
垂	tgaf
笄	tgaj
卸	tghb
眚	tghf
惩	tghn
穗	tgjn
筻	tgjr
衙	tgks
甥	tgle
熏	tglo
掣	tgmr
箦	tgmu
逄	tgpk
秣	tgsy
徕	tgus
段	thdc
篡	thdc
徘	thdd
纂	thdi
臭	thdu
怎	thfn
迮	thfp
版	thgc
牍	thgd
牌	thgf
牒	thgs
牖	thgs
徙	thhy
鼾	thlf
齄	thlg
劓	thlj
鼽	thlv
延	thnp
筲	tief
愆	tign
筛	tjgh
稞	tjsy
犁	tjtg
篮	tjtl
馥	tjtt
篑	tkhm
雒	tkwy
衄	tlng
箩	tlqu
躺	tmdk
躯	tmdr
躲	tmds
躬	tmdx
秧	tmdy
稠	tmfk
筒	tmgk
徽	tmgt
徵	tmgt
笕	tmqb
邬	tnnb
筷	tnnw
迄	tnpv
鄱	tolb
翻	toln
簖	tonr
愁	tonu
黧	tqto
箨	trcg
箝	trff
徨	trgg
笊	trhy
篼	trqq
簌	tskw
篷	ttdp
笙	ttgf
攵	ttgy
筵	tthp
篦	ttlx
笫	ttnt
夂	ttny
彳	ttth
舡	tuag
艘	tuec
科	tufh
乎	tufk
舻	tuhn
艄	tuie
箪	tujf
螽	tujj
舯	tukh
舳	tumg
舢	tumh
舨	turc
舸	tusk
舴	tutf
艏	tuuh
舱	tuwb
般	tuwc
磐	tuwd
剩	tuxj
舭	tuxx
舣	tuyr
舫	tuyt
舷	tuyx
筌	twgf
签	twgg
簦	twgu
黏	twik
稔	twyn
胤	txen
鳘	txtg
繁	txti
後	txty
秕	txxn
篙	tymk
簇	tytd
瓶	uagy
痨	uape
朔	ubte
癃	ubtg
逆	ubtp
槊	ubts
羟	ucag
闯	ucgd
羧	ucwt
瘫	ucwy
瘛	udhn
闼	udpi
煎	uejo
剪	uejv
痂	uekd
瘸	uekw
阌	uepc
瘐	uewi
奘	ufdu
痔	uffi
阗	ufhw
痣	ufni
美	ugdu
瘃	ugey
眷	ughf
判	ugjh
痘	ugku
痖	ugod
羔	ugou
鲞	ugqg
冽	ugqj
叛	ugrc
瘗	uguf
姜	ugvf
凄	ugvv
痍	ugxw
癍	ugyg
阒	uhdi
站	uhkg
郸	ujfb
冁	ujfe
童	ujff
单	ujfj
阊	ujjd
竭	ujqn
羯	ujqn
韵	ujqu
歆	ujqw
戆	ujtn
闾	ukkd
兑	ukqb
况	ukqn
痹	ulgj
甑	uljy
瘕	unhc
爿	unht
瘳	unwe
羝	uqay
酱	uqsg
盗	uqwl
资	uqwm
恣	uqwn
粢	uqwo
姿	uqwv
瓷	uqwy
瘤	uqyl
奠	usgd
猷	usgd
酋	usgf
遵	usgp
遒	usgp
疴	uskd
辣	uskg
竦	uskg
瘌	uskj
癞	uskm
痴	utdk
彦	utee
痄	uthf
馘	uthg
夔	utht
瘪	uthx
瘢	utuc
瘅	uujf
瘴	uujk
癔	uujn
鄯	uukb
善	uukf
阅	uukq
鹣	uvjg
歉	uvjw
阕	uwgd
蠲	uwlj
飒	uwry
羚	uwyc
准	uwyg
鹈	uxhg
剃	uxhj
递	uxhp
孳	uxxb
鹚	uxxg
慈	uxxn
疰	uygd
疒	uygg
辛	uygh
丬	uygh
凉	uyiy
辨	uytu
瘀	uywu
阏	uywu
闶	uywv
媸	vbhj
胬	vcmw
妤	vcnh
娃	vffg
孀	vfsh
婊	vgey
嫦	viph
逯	vipi
娌	vjfg
剿	vjsj
劭	vket
娉	vmgn
彐	vngg
艮	vngy
婿	vnhe
妞	vnhg
巛	vnnn
娇	vtdj
姝	vtfy
郡	vtkb
群	vtku
嫜	vujh
馗	vuth
妒	vynt
垡	waff
偃	wajv
儆	waqt
袋	waye
牮	wayg
贷	waym
岱	waym
黛	wayo
侔	wctg
傩	wcwy
俺	wdjn
俦	wdtf
俸	wdwg
仗	wdyy
郐	wfcb
刽	wfcj
伎	wfcy
侍	wffy
畲	wfil
佘	wfiu
佶	wfkg
舒	wfkh
僖	wfkk
伟	wfnh
侄	wgcf
毹	wgee
倩	wgeg
俞	wgej
逾	wgep
觎	wgeq
佥	wgig
敛	wgit
俅	wgiy
龠	wgka
命	wgkb
合	wgkf
鸽	wgkg
盒	wgkl
颌	wgkm
翕	wgkn
拿	wgkr
登	wgku
凳	wgkw
歙	wgkw
龛	wgky
俩	wgmw
俪	wgmy
佤	wgny
夙	wgqi
傲	wgqt
叙	wgsc
斜	wgsf
途	wgsp
倏	whtd
悠	whtn
攸	whty
仲	wkhh
侃	wkkn
煲	wkso
儇	wlge
俜	wmgn
佻	wqiy
佝	wqkg
凰	wrgd
傀	wrqc
飑	wrqn
仟	wtfh
仵	wtfh
赁	wtfm
恁	wtfn
凭	wtfw
侏	wtfy
佚	wtgy
作	wthf
仡	wtnn
倦	wugb
伴	wugh
岔	wvmj
忿	wvnu
伧	wwbn
佾	wweg
侩	wwfc
傺	wwfi
俭	wwgg
佩	wwgh
偷	wwgj
鹆	wwkg
欲	wwkw
怂	wwnu
俗	wwwk
僬	wwyo
偕	wxxr
邻	wycb
领	wycm
翎	wycn
瓴	wycy
伪	wyey
隼	wyfj
住	wygg
僦	wyiy
偏	wyna
衾	wyne
含	wynk
贪	wynm
颔	wynm
念	wynn
鹪	wyog
劁	wyoj
禽	wyrc
绁	xann
绔	xdfn
疆	xfgg
纬	xfnh
缱	xkhp
绳	xkjn
纽	xnhg
纟	xnng
母	xnny
彝	xoxa
鬻	xoxh
肄	xtdg
颖	xtdm
缝	xtdp
缵	xtfm
绛	xtgh
绗	xtgs
绺	xthk
纥	xtnn
缒	xtnp
绻	xugb
纨	xvyy
鸶	xxgg
毙	xxgx
幺	xxxx
诓	yagg
讵	yang
憝	ybtn
塾	ybvf
孰	ybvy
诵	yceh
谲	ycnk
谖	yegc
裔	yemk
羸	yeuy
诖	yffg
讳	yfnh
诔	yfsy
诼	ygey
剂	yjjh
裹	yjse
衰	ykge
谴	ykhp
谔	ykkn
瓤	ykky
禀	ylki
敲	ymkc
肩	yned
肓	ynef
望	yneg
词	yngk
扉	ynhd
昶	ynij
扈	ynkc
扁	ynma
扃	ynmk
翩	ynmn
扇	ynnd
忘	ynnu
劾	ynte
肇	yntg
綮	ynti
谧	yntl
颏	yntm
亥	yntw
妄	ynvf
谬	ynwe
诀	ynwy
脔	yomw
燮	yooc
谜	yopy
鸾	yoqg
谊	ypeg
亳	ypta
谵	yqdy
诤	yqvh
诱	ytbt
旖	ytdk
旗	ytdw
膂	ytee
旄	yten
诰	ytfk
诜	ytfq
诛	ytfy
诈	ythf
旃	ytmy
旋	ytnh
旎	ytnx
旌	yttg
旒	ytyk
帝	yuph
啻	yupk
斓	yusl
讼	ywcy
谕	ywgj
谶	ywwg
讹	ywxn
谂	ywyn
谯	ywyo
壅	yxtf
饔	yxtv
文	yygy
谝	yyna
该	yynw
谪	yyud
谛	yyuh
